11,9
....XXX....
....XX.....
D....X.....
...........
.S...XX..EE
.S.......EE
...........
......XX...
.X....XXX..
