11,9
....XXX....
....XX.....
D....X.....
...........
.S...XX..E.
.S.........
...........
......XX...
.X....XXX..
