9,7
...EE....
..EEE....
...EE....
.XXX.....
.DS.X....
.SSXX....
XXXXX....
