# BEST 57
11,9
XXXXXXXXXXX
X........DX
X..E.X.SS.X
X...XX..S.X
X......X..X
X..E..XX..X
X.........X
X....E....X
XXXXXXXXXXX
