# BEST 28
9,9
XXXXXXXXX
XE....X..
X.D...X..
X.S.E.X..
X..S..X..
XE.SX.X..
X..X.XX..
X.XXXX...
XXXXXXXXX
