#BEST 5 SW/SE/E/NE/NE
11,9
...........
...XXXX....
...XEEEX...
..XESSEX...
..XESDSEX..
..XESSEX...
...XEEEX...
...XXXX....
...........
