#BEST 12
11,9
XXXXXXXXXXX
X.........X
XDS.......X
XSS...EEEXX
X......XXXX
XXXXXXXXXXX
...........
...........
...........
