#BEST 39
11,9
XXXXXXXXXXX
XE..E.....X
X.X..X.X..X
X..X......X
X.E....X..X
X...X..SSXX
X.X...X.S.X
X......X.DX
XXXXXXXXXXX
