#BEST 15
11,9
XXXXXXXXXXX
X.......EXX
X..XXX...XX
X..XXXE.X.X
X...XXXX..X
X...EXXXS.X
X.....XXS.X
XE.....S.DX
XXXXXXXXXXX
