11,9
X.......EEE
.X......EEE
........EEE
.X...XX....
....XXX....
...X...XX..
D.XX.X.....
SX...X.....
SS....X....
