.........
.........
.....x...
....o..x.
....x....
.......x.
.........
